000000000000000000000000000000000000000000000000000000000000000000000000000000000000000000000000000000000000000000000000000000000000000000000000000000000000000000000000000000000000000000000000000000000000000
000000000000000000000000000000000000000000000000000000000000000000000000000000000000000000000000000000000000000000000000000000000000000000000000000000000000000000000000000000000000000000000000000000000000000
000000000000000000000000000000000000000000000000000000000000000000000000000000004040000000000000000000000000000000000000000000000000000000000000000000000000000000000000000000000000000000000000000000000000000
000000000000000000000010000000000000000000000000000000000000000000000000000000001111111110001110000000000000010000000000001110000011110000000000000000000000000000000000000000000000000000000110000000000000000
000000000000000000000000000000000000000000000000000000000000000000000000000000000000000000000000000000000000000000000000000000000000000000000000000000000000000000000000000000000000000000001110000000000000000
000000000000000000000000000000000000000000000000000000000000000000000000000000000000000000000000000000000000000000000000000000000000000000000000000000000000000000000000000000000000000000011110000000000000000
000000000000000000000000000000000000000000000000000000000000000000000000000000000000000000000000000000000000000000000000000000000000000000000000000000000000000000000000000000000000000000111110000000000000000
000000000000000010001111100000000000000000000033000000000330000000000000000001110000000000000010000011000010010010000010000000000001100000100100000000001100100000000000011111000000000001111110000000000000000
000000000000000000000000000000000000003300000033000000000330000000000000000000000000000000000000000000000000000000000000000000000000000001100110000000011100110000000000000000000000000011111110000000000000000
000000000000000000000000000033000000003300000033000000000330000000000000000000000000000000000000000000000000000000000000000000000000000011100111000000111100111000003300000000000000330111111110000000000000000
000000000000000000000040000033000000003340000033000440000330000000000000000000000000000000000000040400000004000000404000000040400404000111100111100001111100111100003300000000040400331111111110000000010000000
222222222222222222222222222222222222222222222222222222222222222222220022222222222222200022222222222222222222222222222222222222222222222222222222222222222200222222222222222222222222222222222222222222222222222