0000000000000000000000
0000000000000000000000
0000000000000000000000
0000000000000000000000
0000000000000000000000
0000000000000000000000
0000000000000000000000
0000000010000000000001
0000000110000000000001
0000001110000000000001
0000011110330010000001
2222222222222222222222